+++++++++++++++++++++++++++++
+X!o o!o o!o o!o o!o o!o o!o+
+o!o!o!o!o!o!o!o!o!o!o!o!o!o+
+o!o!o!o!o!o!o!o!o!o!o!o!o!o+
+  o!o o!o o!o o!o o!o o!o  +
+       G           G       +
+!!!!!!!!!!!!!!!!!!!!!!!!!!!+
+ ooooooX     P     Xoooooo +
+!!!!!!!!!!!!!!!!!!!!!!!!!!!+
+       G           G       +
+  o!o o!o o!o o!o o!o o!o  +
+o!o!o!o!o!o!o!o!o!o!o!o!o!o+
+o!o!o!o!o!o!o!o!o!o!o!o!o!o+
+X!o o!o o!o o!o o!o o!o o!o+
+++++++++++++++++++++++++++++